##############
#S#t#       t#
# # #  ###  ##
# # #B##t#   #
# # #### ### #
#      #  R# #
#####  # ### #
#  t#  # #   #
# ###  # # ###
# #O   # # #P#
# ###  # # # #
#            #
##############